----------------------------------------------------------------------------------------------------
----------------------------------------------------------------------------------------------------
----------------------------------------------------------------------------------------------------
----------------------------------------------------------------------------------------------------
---------WWWWWWWWWWWWWWWWWWWWWWWWWWWWWWWWWWWWWWWWWWWWWWWWWWWWWWWWWWWWWWWWWWWWWWWWWWWWWWWWW----------
---------W-------------------------------------------------------------------------------W----------
---------W-----------------------WWWWWW---WWWWWW--WW---WW-WWWWWWW------------------------W----------
---------W-----------------------WW---WW-WW----WW-WW--WW--WW-----------------------------W----------
---------W-----------------------WWWWWW--WW----WW-WWWWW---WWWWW--------------------------W----------
---------W-----------------------WW------WW----WW-WW--WW--WW-----------------------------W----------
---------W-----------------------WW-------WWWWWW--WW---WW-WWWWWWW------------------------W----------
---------W-------------------------------------------------------------------------------W----------
---------W---------------WWWWWW-WWWWWWW-WWW----WW-WWWWWWWW-WWWWWWW-WWWWWW----------------W----------
---------W--------------WW------WW------WWWW---WW----WW----WW------WW---WW---------------W----------
---------W--------------WW------WWWWW---WW-WW--WW----WW----WWWWW---WWWWWW----------------W----------
---------W--------------WW------WW------WW--WW-WW----WW----WW------WW---WW---------------W----------
---------W---------------WWWWWW-WWWWWWW-WW---WWWW----WW----WWWWWWW-WW---WW---------------W----------
---------W-------------------------------------------------------------------------------W----------
---------WWWWWWWWWWWWWWWWWWWWWWWWWWWWWWWWWWWWWWWWWWWWWWWWWWWWWWWWWWWWWWWWWWWWWWWWWWWWWWWWW----------
---------W-------------------------------------------------------------------------------W----------
---------W-------------------------------------------------------------------------------W----------
---------W-------------------------------------------------------------------------------W----------
---------WWWWWWWWWWWWWWW---------------------------------------------------WWWWWWWWWWWWWWW----------
---------W-------------W---------------------------------------------------W-------------W----------
---------W-------------W---------------------------------------------------W-------------W----------
---------W-------------WW-------------------------------------------------WW-------------W----------
---------W-------------WH-------------------------------------------------HW-------------W----------
---------W-------------WW-------------------------------------------------WW-------------W----------
---------W-------------W---------------------------------------------------W-------------W----------
---------WWWWWWWWWWWWWWW---------------------------------------------------WWWWWWWWWWWWWWW----------
---------W-------------------------------------------------------------------------------W----------
---------W-------------------------------------------------------------------------------W----------
---------W-------------------------------------------------------------------------------W----------
---------W-------------------------------------------------------------------------------W----------
---------WWWWWWWWWWWWWWWWWWWWWWWWWWWWWWWWWWWWWWDWWWWWWWWWWWWWWWWWWWWWWWWWWWWWWWWWWWWWWWWWW----------
----------------------------------------------------------------------------------------------------
----------------------------------------------------------------------------------------------------
----------------------------------------------------------------------------------------------------
----------------------------------------------------------------------------------------------------
----------------------------------------------------------------------------------------------------