WWWWWWWWWWWWWWWWWWWWWWWWWWWWWWWWWWWWWWWWWWWWWWWWWWWWWWWWWWWWWWWWWWWWWWWWWWWWWWWWWWWWWWWWWWWWWWWWWWWW
W-------------------------------------WW-----CCCCCCCCCCCCCCCCCCCCCCCCCCCCCCCCCCCCCCCCCCCCCCCCC-----W
W------WWWWWWWWWWWWWWWWWWWWWWWWWW-----WW-----CCCCCCCCCCCCCCCCCCCCCCCCCCCCCCCCCCCCCCCCCCCCCCCCC-----W
W------WWWWWWWWWWWWWWWWWWWWWWWWWW-----WW-----CCCCCCCCCCCCCCCCCCCCCCCCCCCCCCCCCCCCCCCCCCCCCCCCC-----W
W------WWWWWWWWWWWWWWWWWWWWWWWWWW-----WW-----CCCCCCCCCCCCCCCCCCCCCCCCCCCCCCCCCCCCCCCCCCCCCCCCC-----W
W------WWWWWWWWWWWWWWWWWWWWWWWWWW-----WW-----CCCCCCCCCCCCCCCCCCCCCCCCCCCCCCCCCCCCCCCCCCCCCCCCC-----W
W------WWWWWWWWWWWWWWWWWWWWWWWWWW-----WW-----------WWWWWWWWWWWWWWWWWWWWWWWWWWWWWWWWWWWW------------W
W------WWWWWWWWWWWWWWWWWWWWWWWWWW-----WW---------------------------------------------WW------------W
W------WWWWWWWWWWWWDWWWWWWWWWWWWW-----WW----------CCCCCCCCCCCCCCCCCCCCCCCCCCCCC------WW------------W
W-------------------------------------WW----------CCCCCCCCCCCCCCCCCCCCCCCCCCCCC------WW------------W
W-------------------------------------WW----------CCCCCCCCCCCCCCCCCCCCCCCCCCCCC------WW------------W
W-------------------------------------WW----------CCCCCCCCCCCCCCCCCCCCCCCCCCCCC------WW------------W
W-------------------------------------WW----------CCCCCCCCCCCCCCCCCCCCCCCCCCCCC------WW------------W
W-------------------------------------WW----------CCCCCCCCCCCCCCCCCCCCCCCCCCCCC------WW------------W
W-------------------------------------WW---------------------------------------------WW------------W
W-------------------------------------WW---------------------------------------------WW------------W
W-------------------------------------WW---------------------------------------------WW------------W
W-------------------------------------WW---------------------------------------------WW------------W
W-------------------------------------WW---------------------------------------------WW-------------
W-------------------------------------WW---------------------------------------------WW-------------
W-------------------------------------WW---------------------------------------------WW-------------
W-------------------------------------WW---------------------------------------------WW------------W
W-------------------------------------WW---------------------------------------------WW------------W
W-------------------------------------WW---------------------------------------------WWWWWWWWWWWWWWW
W-------------------------------------WW-----------------------------------------------------------W
W-------------------------------------WW-----------------------------------------------------------W
W-------------------------------------WW-----------------------------------------------------------W
W-----------------------CCCCCCCCCCCCCCCCCCCCCCCCCCCCC----------------------------------------------W
W-----------------------CCCCCCCCCCCCCCCCCCCCCCCCCCCCC----------------------------------------------W
W-----------------------CCCCCCCCCCCCCCCCCCCCCCCCCCCCC----------------------------------------------W
W-----------------------CCCCCCCCCCCCCCCCCCCCCCCCCCCCC----------------------------------------------W
W-----------------------CCCCCCCCCCCCCCCCCCCCCCCCCCCCC----------------------------------------------W
W-----------------------CCCCCCCCCCCCCCCCCCCCCCCCCCCCC----------------------------------------------W
WWWWWWWWWWWWWWWWWWWWWWWWWWWWWWWWWWWWWWWWWWWWWWWWWWWWWWWWWWWWWWWWWWWWCCCCCCCCCCCCCCCCCCCCCCCCCCCCCCCW
WCCCCCCCCCCCCCCCCCCCCCCCCCCCCCCCCCCCCCCCCCCCCCCCCCCCCCCCCCCCCCCCCCCCCCCCCCCCCCCCCCCCCCCCCCCCCCCCCCCW
WCCCCCCCCCCCCCCCCCCCCCCCCCCCCCCCCCCCCCCCCCCCCCCCCCCCCCCCCCCCCCCCCCCCCCCCCCCCCCCCCCCCCCCCCCCCCCCCCCCW
WCCCCCCCCCCCCCCCCCCCCCCCCCCCCCCCCCCCCCCCCCCCCCCCCCCCCCCCCCCCCCCCCCCCCCCCCCCCCCCCCCCCCCCCCCCCCCCCCCCW
WCCCCCCCCCCCCCCCCCCCCCCCCCCCCCCCCCCCCCCCCCCCCCCCCCCCCCCCCCCCCCCCCCCCCCCCCCCCCCCCCCCCCCCCCCCCCCCCCCCW
WCCCCCCCCCCCCCCCCCCCCCCCCCCCCCCCCCCCCCCCCC-------------CCCCCCCCCCCCCCCCCCCCCCCCCCCCCCCCCCCCCCCCCCCCW
WWWWWWWWWWWWWWWWWWWWWWWWWWWWWWWWWWWWWWWWWWWWWW-----WWWWWWWWWWWWWWWWWWWWWWWWWWWWWWWWWWWWWWWWWWWWWWWWW