WWWWWWWWWWWWWWWWWWWWWWWWWWWWWWWWWWWWWWWWWWWWWWWWWWWWWWWWWWWWWWWWWWWWWWWWWWWWWWWWWWWWWWWWWWWWWWWWWWWW
W--------------------------------------------------------------------------------------------------W
W------WWWWWWWWWWWWWWWWWWWWWWWWWW------------------------------------------------------------------W
W------WWWWWWWWWWWWWWWWWWWWWWWWWW-------------------------------------WWWWWWWWWWWWWWW--------------W
W------WWWWWWWWWWWWWWWWWWWWWWWWWW---------------------------------------------------W--------------W
W------WWWWWWWWWWWWWWWWWWWWWWWWWW---------------------------------------------------W--------------W
W------WWWWWWWWWWWWWWWWWWWWWWWWWW---------------------------------------------------W--------------W
W------WWWWWWWWWWWWWWWWWWWWWWWWWW-------------------------------------WWWWWWWWWWWWWWW--------------W
W------WWWWWWWWWWWWDWWWWWWWWWWWWW-------------------------------------W----------------------------W
W---------------------------------------------------------------------W----------------------------W
W---------------------------------------------------------------------W----------------------------W
W---------------------------------------------------------------------WWWWWWWWWWWWWWW--------------W
W--------------------------------------------------------------------------------------------------W
W--------------------------------------------------------------------------------------------------W
W--------------------------------------------------------------------------------------------------W
W--------------------------------------------------------------------------------------------------W
W--------------------------------------------------------------------------------------------------W
W--------------------------------------------------------------------------------------------------W
------------------------------------------------------WCCCCCCCCCCCCCCCCCCCCCCCCCCCCCCCCCCCCCCCCCCCCW
------------------------------------------------------WCCCCCCCCCCCCCCCCCCCCCCCCCCCCCCCCCCCCCCCCCCCCW
------------------------------------------------------WCCCCCCCCCCCCCCCCCCCCCCCCCCCCCCCCCCCCCCCCCCCCW
W-----------------------------------------------------WCCCCCCCCCCCCCCCCCCCCCCCCCCCCCCCCCCCCCCCCCCCCW
WWWWWWWWWWWWWWWWWWWWWWWWWWWWWWWWWWWWWWWWWWWWWWWWWWWWWWWCCCCCCCCCCCCCCCCCCCCWWWWWWWWWWWWWWWWWWWWWWWWW
W-----------------W--------------------------------------------------------------W-----------------W
W-----------------W--------------------------------------------------------------W-----------------W
W-----------------W--------------------------------------------------------------W-----------------W
W--------W--------W--------W--------------------------------------------W--------W--------W--------W
W--------W--------WCCCCCCCCW--------------------------------------------WCCCCCCCCW--------W--------W
WCCCCCCCCW--------WCCCCCCCCW--------------------------------------------WCCCCCCCCW--------WCCCCCCCCW
WCCCCCCCCW--------WCCCCCCCCW--------------------------------------------WCCCCCCCCW--------WCCCCCCCCW
WCCCCCCCCW--------WCCCCCCCCW--------------------------------------------WCCCCCCCCW--------WCCCCCCCCW
WCCCCCCCCW--------WCCCCCCCCW----CCCCCCCCCCCCCCCCCCCCCCCCCCCCCCCCCCCC----WCCCCCCCCW--------WCCCCCCCCW
WCCCCCCCCW--------W--------W----CCCCCCCCCCCCCCCCCCCCCCCCCCCCCCCCCCCC----W--------W--------WCCCCCCCCW
WCCCCCCCCW-----------------W----CCCCCCCCCCCCCCCCCCCCCCCCCCCCCCCCCCCC----W-----------------WCCCCCCCCW
WCCCCCCCCW-----------------W----CCCCCCCCCCCCCCCCCCCCCCCCCCCCCCCCCCCC----W-----------------WCCCCCCCCW
W--------W-----------------W--------------------------------------------W-----------------W--------W
W--------WWWWWWWWWWWWWWWWWWWWWWWWWWWWWWWWWWWWWWWWWWWWWWWWWWWWWWWWWWWWWWWWWWWWWWWWWWWWWWWWWW--------W
W--------------------------------------------------------------------------------------------------W
W--------------------------------------------------------------------------------------------------W
WWWWWWWWWWWWWWWWWWWWWWWWWWWWWWWWWWWWWWWWWWWWWW-----WWWWWWWWWWWWWWWWWWWWWWWWWWWWWWWWWWWWWWWWWWWWWWWWW