WWWWWWWWWWWWWWWWWWWWWWWWWWWWWWWWWWWWWWWWWWWWWW-----WWWWWWWWWWWWWWWWWWWWWWWWWWWWWWWWWWWWWWWWWWWWWWWWW
W--------------------------------------------------------------------------------------------------W
W------WWWWWWWWWWWWWWWWWWWWWWWWWW------------------------------------------------------------------W
W------WWWWWWWWWWWWWWWWWWWWWWWWWW------------------------------------WWWWWWWWWWWWWW----------------W
W------WWWWWWWWWWWWWWWWWWWWWWWWWW-------------------------------------------------W----------------W
W------WWWWWWWWWWWWWWWWWWWWWWWWWW-------------------------------------------------W----------------W
W------WWWWWWWWWWWWWWWWWWWWWWWWWW-------------------------------------------------W----------------W
W------WWWWWWWWWWWWWWWWWWWWWWWWWW----------------------------------------WWWWWWWWWW----------------W
W------WWWWWWWWWWWWDWWWWWWWWWWWWW-------------------------------------------------W----------------W
W---------------------------------------------------------------------------------W----------------W
W---------------------------------------------------------------------------------W----------------W
W--------------------------------------------------------------------WWWWWWWWWWWWWW----------------W
W--------------------------------------------------------------------------------------------------W
W--------------------------------------------------------------------------------------------------W
W--------------------------------------------------------------------------------------------------W
W--------------------------------------------------------------------------------------------------W
W--------------------------------------------------------------------------------------------------W
WWWWWWWWWWWWWWWWWWWWWWWWWWWWWWWWWWWWWWWWWWWWWWWWWWWWWWWWWWWWWWW---------WWWWWWWWWWWWWWWWWWWWWWWWWWWW
W------------------------------W------------------------------W---------W---------------------------
W------------------------------W------------------------------W---------W---------------------------
W---------W--------------------W--------------------W---------W---------W---------------------------
W---------W--------------------W--------------------W---------W---------W--------------------------W
W---------W--------------------W--------------------W---------W---------WCCCCCC-CCCCCCCCCCCCCCCCCCCW
W---------WCCCCCCCCCCCCCCCCCCCCWCCCCCCCCCCCCCCCCCCCCW---------W---------WCCCCCC-----------------CCCW
W---------WCCCCCCCCCCCCCCCCCCCCWCCCCCCCCCCCCCCCCCCCCW---------W---------WCCCCCCCCCCCCCCCCCCCCCC-CCCW
W---------WCCCCCCCCCCCCCCCCCCCCWCCCCCCCCCCCCCCCCCCCCW---------W---------WCCCCCCCCCCCC------CCCC-CCCW
W---------W--------------------W--------------------W---------W---------WCCCCCCCCCCCC-CCCC-CCCC-CCCW
W---------WCCCCCCCCCCCCCCCCCCCCWCCCCCCCCCCCCCCCCCCCCW---------W---------WCCCCCCCC-----CCCC-CCCC-CCCW
W---------WCCCCCCCCCCCCCCCCCCCCWCCCCCCCCCCCCCCCCCCCCW---------W---------WCCCCCCCC-CCCCCCCC------CCCW
W---------WCCCCCCCCCCCCCCCCCCCCWCCCCCCCCCCCCCCCCCCCCW---------W---------WCCCCCCCC-CCCCCCCCCCCCCCCCCW
W---------W--------------------W--------------------W---------W---------WCCCCCCCC-CCC---------CCCCCW
W---------W-----------------------------------------W---------W---------WCCCCCCCC-CCC-CCCCCCC-CCCCCW
W---------W-----------------------------------------W---------W---------WCCCCCCCC-----CCCCCCC-CCCCCW
W---------W-----------------------------------------W-------------------WCCCCCCCCCCCCCCCCCCCC-CCCCCW
W---------W-----------------------------------------W-------------------WCCCCCCCCCCCCCCCCCCCC-CCCCCW
W---------WWWWWWWWWWWWWWWWWWWWWWWWWWWWWWWWWWWWWWWWWWWWWWWWWWWWWWWWWWWWWWW--------------------------W
W-------------------CCCCCCCCCCCCCCCCCCCCCCCCCCCCCCCCCCCCCCCCCCC------------------------------------W
W-------------------CCCCCCCCCCCCCCCCCCCCCCCCCCCCCCCCCCCCCCCCCCC------------------------------------W
W-------------------CCCCCCCCCCCCCCCCCCCCCCCCCCCCCCCCCCCCCCCCCCC------------------------------------W
WWWWWWWWWWWWWWWWWWWWWWWWWWWWWWWWWWWWWWWWWWWWWWWWWWWWWWWWWWWWWWWWWWWWWWWWWWWWWWWWWWWWWWWWWWWWWWWWWWWW