WWWWWWWWWWWWWWWWWWWWWWWWWWWWWWWWWWWWWWWWWWWWWW-----WWWWWWWWWWWWWWWWWWWWWWWWWWWWWWWWWWWWWWWWWWWWWWWWW
W--------------------------------------------------------------------------------------------------W
W------WWWWWWWWWWWWWWWWWWWWWWWWWW------------------------------------------------------------------W
W------WWWWWWWWWWWWWWWWWWWWWWWWWW-----------------------------------------WWW----------------------W
W------WWWWWWWWWWWWWWWWWWWWWWWWWW----------------------------------------WW-W----------------------W
W------WWWWWWWWWWWWWWWWWWWWWWWWWW---------------------------------------WW--W----------------------W
W------WWWWWWWWWWWWWWWWWWWWWWWWWW--------------------------------------WW---W----------------------W
W------WWWWWWWWWWWWWWWWWWWWWWWWWW-------------------------------------WW----W----------------------W
W------WWWWWWWWWWWWDWWWWWWWWWWWWW------------------------------------WWWWWWWWWWWW------------------W
W---------------------------------------------------------------------------W----------------------W
W---------------------------------------------------------------------------W----------------------W
W--------------------------------------------------------------------------------------------------W
W--------------------------------------------------------------------------------------------------W
W--------------------------------------------------------------------------------------------------W
W--------------------------------------------------------------------------------------------------W
W--------------------------------------------------------------------------------------------------W
W--------------------------------------------------------------------------------------------------W
W--------------------------------------------------------------------------------------------------W
---------------------------------------------------------------------------------------------------W
---------------------------------------------------------------------------------------------------W
---------------------------------------------------------------------------------------------------W
WWWWWWWWWWWWWWWWWWWWWWWWWWWWWWWWWWWWWWWWWWWWWWWWWWWWWWWWWWWWWWW------------------------------------W
W--------------------------------------------------------------------------------------------------W
W--------CCCCCCCCCCCCCCCCCCCCCCCCCCCCCCCCCCCCCCCCCCCCCCCCCCCCCCCCCCCCCCCCCCCCCCCCCCCCCCCCCC--------W
W--------CCCCCCCCCCCCCCCCCCCCCCCCCCCCCCCCCCCCCCCCCCCCCCCCCCCCCCCCCCCCCCCCCCCCCCCCCCCCCCCCCC--------W
W--------CCCCCCCCCCCCCCCCCCCCCCCCCCCCCCCCCCCCCCCCCCCCCCCCCCCCCCCCCCCCCCCCCCCCCCCCCCCCCCCCCC--------W
W--------CCCCCCCCCCCCCCCCCCCCCCCCCCCCCCCCCCCCCCCCCCCCCCCCCCCCCCCCCCCCCCCCCCCCCCCCCCCCCCCCCC--------W
W--------CCCCCCCCCCCCCCCCCCCCCCCCCCCCCCCCCCCCCCCCCCCCCCCCCCCCCCCCCCCCCCCCCCCCCCCCCCCCCCCCCC--------W
W--------CCCCCCCCCCCCCCCCCCCCCCCCCCCCCCCCCCCCCCCCCCCCCCCCCCCCCCCCCCCCCCCCCCCCCCCCCCCCCCCCCC--------W
W--------------------------------------------------------------------------------------------------W
W--------------------------------------------------------------------------------------------------W
W----------WWWWWW----WWWWWWW---WWWWWWW--WWWWWWWW-----WW-------WW-----WW--WWWWWW--WW----WW----------W
W---------WW----WW--WW-----WW-WW-----WW-WW-----WW----WW-------WW-----WW-WW----WW-WW---WW-----------W
W---------WW--------WW-----WW-WW-----WW-WW-----WW----WW-------WW-----WW-WW-------WW--WW------------W
W---------WW---WWWW-WW-----WW-WW-----WW-WW-----WW----WW-------WW-----WW-WW-------WWWWW-------------W
W---------WW----WW--WW-----WW-WW-----WW-WW-----WW----WW-------WW-----WW-WW-------WW--WW------------W
W---------WW----WW--WW-----WW-WW-----WW-WW-----WW----WW-------WW-----WW-WW----WW-WW---WW-----------W
W----------WWWWWW----WWWWWWW---WWWWWWW--WWWWWWWW-----WWWWWWWW--WWWWWWW---WWWWWW--WW----WW----------W
W--------------------------------------------------------------------------------------------------W
WWWWWWWWWWWWWWWWWWWWWWWWWWWWWWWWWWWWWWWWWWWWWWWWWWWWWWWWWWWWWWWWWWWWWWWWWWWWWWWWWWWWWWWWWWWWWWWWWWWW